R X R R T
X K R X R
R R T X X
X R X R R
R X R X R